XXXXXXXXXXXXXXXXXX
X00XXXXXXXXXXXX00X
X00XXXXXXXXXXXX00X
XX00000XXXX00000XX
XX00000XXXX00000XX
XXXXXXXXXXXXXXXXXX
XXXX    XX   bXXXX
XXXX          XXXX
X00XXXR XX  XXX00X
X0000X  XX XX0000X
X0000X     XX0000X
XXX00X      X00XXX
XXX00X  XX  X00XXX
XXXXXXB    rX00XXX
XXX00XXXXXXXX00XXX
XXX00XXX00XXX00XXX
XXXX0000000000XXXX
XXXXXXXXXXXXXXXXXX