XXXXXXXXXXXXXXXXXX
XXX000000000000XXX
XX00XXXXXXXXXX00XX
X00XX   XX   XX00X
X0XX          XX0X
X0X       X    X0X
X0X   XX  XX   X0X
X0X   XB  YX   X0X
X0XX    XX    XX0X
X0XX    XX    XX0X
X0X   XR  GX   X0X
X0X   XX  XX   X0X
X0X          r X0X
X0XX        ybXX0X
X00XX   XX   XX00X
XX00XXXXXXXXXX00XX
XXX000000000000XXX
XXXXXXXXXXXXXXXXXX