XXXXXXXXXXXXXXXXXX
XXXX0XXXXXXXX0XXXX
XXX0X0X0XX0X0X0XXX
XX0X0X0X00X0X0X0XX
X0XXXXXXXXXXXXXX0X
XXX       B g XXXX
XXX  XX     X  XXX
X0Xr           X0X
X0XX X  XX XX  X0X
X0XX    XX X  XX0X
X0XXXX    GX   X0X
XXX          XXXXX
XXX    XX R   XXXX
X0X       X   XX0X
XX0XX    bX  XX0XX
XXX0XXXXXXXXXX0XXX
XXXX0XX0XX0XX0XXXX
XXXXXXXXXXXXXXXXXX